Hoofdsteden van provincies:
	Drenthe	Assen
	Flevoland	Lelystad
	Friesland	Leeuwarden
	Gelderland	Arnhem
	Groningen	Groningen
	Limburg	Maastricht
	Noord-Brabant	s-Hertogenbosch
	Noord-Holland	Haarlem
	Overijssel	Zwolle
	Utrecht	Utrecht
	Zeeland	Middelburg
	Zuid-Holland	Den Haag

Hoofdsteden van Europa:
	België	Brussel
	Bulgarije	Sofia
	Cyprus	Nicosia
	Denemarken	Kopenhagen
	Duitsland	Berlijn
	Estland	Tallinn
	Finland	Helsinki
	Frankrijk	Parijs
	Griekenland	Athene
	Hongarije	Boedapest
	Ierland	Dublin
	Italië	Rome
	Kroatië	Zagreb
	Letland	Riga
	Litouwen	Vilnius
	Luxemburg	Luxemburg
	Malta	Valletta
	Nederland	Amsterdam
	Oostenrijk	Wenen
	Polen	Warschau
	Portugal	Lissabon
	Roemenië	Boekarest
	Slovenië	Ljubljana
	Slowakije	Bratislava
	Spanje	Madrid
	Tsjechië	Praag
	Zweden	Stockholm